...............
.{..........}..
...............
...............
.xR...C.C...Lx.
...............
...............
...............
.\.....S...../.
...............