xxxxxxxxxxxxxxx
x{DDDDDDDDDDD}x
xR.....S.....Lx
xRC...UuU...CLx
xRC../^^^\..CLx
xRC.l<xxx>r.CLx
xR...}vvv{...Lx
xR....DdD....Lx
x\UUUUUUUUUUU/x
xxxxxxxxxxxxxxx