xxxxxxxxxxxxxxx
xC.....E.....Cx
x.............x
x.............x
x.............x
x.............x
x.............x
x.............x
xC.....S.....Cx
xxxxxxxxxxxxxxx