...............
.{...........}.
.......u.......
.U.....x.....U.
LxR.LxC.CxR.LxR
.D.....x.....D.
.......d.......
...............
.\.....S...../.
...............