xxxxxxxxxxxxxxx
x{....C.C....}x
x.............x
x.....C.C.....x
x......S......x
x...UUUUUUU...x
x../^^^^^^^\..x
x.............x
x\.UUUuUuUUU./x
xxxxxxxxxxxxxxx