xxxxxxxxxxxxxxx
xC...........Cx
x.............x
x....}vvv{....x
xr....DDD....l<
xr....UuU....l<
x..../^^^\....x
x......S......x
xC...........Cx
xxxxxxxxxxxxxxx