xxxxxxxxxxxxxxx
xC....CC.....Cx
xE...........Ex
x.............x
xxr.........lxx
x.............x
x.............x
x.............x
x......S......x
xxxxxxxxxxxxxxx