C.....C.C.....C
\............./
xR.....S.....Lx
{.....C.C.....}
...............
....UuUUuU.....
.../^^^^^^\....
...}vvvvvv{....
....DdDDdD.....
...............