C.............C
..}vvvvvvvvv{..
...DDDDdDDDD...
...............
..>R..C.C..L<..
..>R.......L<..
.......S.......
...UUUUUUUUU...
../^^^^^^^^^\..
C.............C