C.....C.C.....C
\............./
xR.....S.....Lx
xR....C.C....Lx
xR...........Lx
xR..UUUuUUU..Lx
xr./^^^^^^^\.lx
xr.}vvvvvvv{.lx
{...DDDdDDD...}
......C.C......